

R  1024  768
C  255,255,100
F  100,255,0

NO ./pics/SP_DUDE1.xpm
SO ./pics/MARBFACE.xpm
EA ./pics/colorstone.xpm
WE ./pics/mossy.xpm
S ./pics/imp.xpm

            

           
           
11111111111
10000000001
10010000101
10000000001
10000N00001
10010000101
10000000001
11111111111