

R  1024  768
C  255,255,100
F  100,255,0

NO ./pics/SP_DUDE1.xpm
SO ./pics/MARBFACE.xpm
EA ./pics/colorstone.xpm
WE ./pics/mossy.xpm
S ./pics/imp.xpm

            

                     11111111
                     10000001
11111111111111111111110000001
10000000000000000000000000001
10000000000001111111110000001
11110000200001110000000000001
    1002220001110000000000001
    1000200000111000W00000001
11110000000001111111110000001
10000000000000000000010000001
10000000000000000001110000001
10000000000000000000000000001
10000000000000000000001111101
11111111111111111111111   111
